.....|.....#
#..#||||...#
#..#~~#|....
#..#~~#|....
#~~~~~#|....
#~~~~~#|....
#######|....
.......|....
..|||||||||.
..|#~~~~~#|.
..|#~~~~~#|.
..|#~~~~~#|.
..|#######|.